freshcut: freshcut, fresh cut
papyrus: papyrus, papy rus
lovepop: lovepop, love pop
hallmark: hallmark
greeting american: greeting american
paperlove: paperlove, paper love

christmas: christmas, xmas, noel, yuletide

newyear: newyear, new year, new-year, nye

valentine: valentine, valentines, valentine's

anniversary: anniversary, anniversaries, wedding anniversary

holiday: holiday, holidays, vacation, break

us: us
children: children
brother and sister: brother and sister
son & dad: son & dad, son and dad
parents: parents
family: family

cat: cat, cats, kitten, kitty, feline

kid: kid, kids, child, baby, toddler, children, childrens, children's, youngster

birthday: birthday, birthdays, bday, birth day

fish: fish, fishes, marine, aquatic

dragon: dragon, dragons

cheerful: cheerful, cheery

joyful: joyful, joyous, gleeful

fun: fun, funny, funs, funnies, fun's, funny's, funs', funnies'

helper: helper, assistant, supporter

team: team, group

halloween: halloween
pumpkin: pumpkin
trick or treat: trick or treat

thank you: thanks, thank, thankful, gratitude

mother: mother, mom, mum, mothers, mother's, mothers', stepmother, mama, mommy, mummy, momma, mamma, ma

girl: girl, girls, female child, young woman

daughter: daughter, daughters

father: father, fathers, dad, dads, papa, papas, father's, fathers'

uncle: uncle, uncles, uncle figure

aunt: aunt, aunts, auntie

grandchild: grandchild, grandkids, grand children

grandparent: grandparent, grandparents, elder

parenthood: parenthood, fatherhood, motherhood